11111111111111111111
10000000000000000011
1000C000000000000011
10000000000000000011
1000000P000000000011
1000000E000000000011
10000000000000000011
10000000000000000011
11111111111111111111
